|||||||||||||||||||||||||||||||||||||||||||||||||
|S      |           |             |             |
| ||||| ||||| ||||| ||||||| ||||||||||| ||||||| |
| |   |       |                   |     |       |
| | ||||| ||||||||| ||||| ||||| ||| ||||| ||| | |
| |     | |       | |   | |     | |   |     | | |
| ||||| | | ||||| | ||||| ||| ||||| ||||||| | |||
| |   | | |   |   |       | |     |   |     |   |
| ||| ||| ||||| ||||||||| | ||| ||||| ||| ||||| |
| |     |                 | |             |   | |
| ||||| ||||||||||||||| ||| ||||| ||| | ||| ||| |
| |     |   |         |   |     | |   |     | | |
| | ||||| | ||||| ||||||||| ||| | ||||| ||| ||| |
| | |   | | |           |   | |   |     |   |   |
||| | ||| ||| ||||| ||| | ||| ||||| ||||| ||| |||
|   |     |       |                 |   |   |   |
| ||||| ||||||| ||| ||| ||| ||| ||| | ||||| |||||
|     |           | |      || |   | |       |   |
||||| ||||||| ||||| ||||||| ||| ||||||||||||| | |
|   |   |       | | |   | | |   |             | |
| | ||||| ||||||| ||| ||||| ||||| ||| ||| | ||| |
| |       |       |             |   |   | |     |
| ||||||||| ||| ||||||||| ||||| | ||| ||||| |||||
|       |   |         |     |       | |       | |
||||||| | ||||| ||| ||| | | ||| ||||| ||| ||| |||
|       |   |   |     | | |   |   |       |   | |
||||| ||||| ||| ||||| | ||||| ||||| ||| ||||| | |
|   |               | |       |   | |   |   |   |
| ||| ||||||||||| ||| | ||| ||||| ||||| ||||||| |
|   |           | |   |   |   |   |   |       | |
||| ||||||||| | | | ||||| ||||| ||| ||||| ||||| |
|   |         |               | |       |      F|
|||||||||||||||||||||||||||||||||||||||||||||||||